 ____  ____   _       ____    ____                  _          
|_   ||   _| (_)     |_   \  /   _|                (_)         
  | |__| |   __        |   \/   |   ,--.   _ .--.  __   ,--.   
  |  __  |  [  |       | |\  /| |  `'_\ : [ `/'`\][  | `'_\ :  
 _| |  | |_  | |  _   _| |_\/_| |_ // | |, | |     | | // | |, 
|____||____|[___])_/ |_____||_____|\'-;__/[___]   [___]\'-;__/ 
                                                               